**********************************
* **********   ************ **   *
*            *            * ** * *
* ***********************      * *
* * *   *   *   *   *  * ******* *
*G*   *   *   *   *              *
**** *****************************
*            *        *********  *
* ****** * * ******** *         **
*      * * * *                 ***
**** * *** * ******           ****
*S   *     *            *    *****
**********************************