**********************************
* **********   ************ **   *
*            *            * ** * *
* ***********************      * *
* * *   *   *   *   *  * ******* *
*G*   *   *   *   *              *
******************************** *
*            *        *********  *
* ****** * * ******** *         **
*      * * * *      * *******  ***
**** * *** * ****** * *   **  ****
*S   *     *            *    *****
**********************************