**********************************
* **********   ************ **   *
*            *            * ** * *
* ***********************      * *
*G***     *   *   *   *  * *******
***     *   *   *                *
**** *****************************
*            *        *********  *
* ****** * * ******** *         **
*      * * * *                 ***
*** * ** * * ******           ****
*   *     *            *    ******
*** ******************************
*                                *
*                                *
*                                *
*                                *
*                                *
*                                *
*                                *
*                *****************
*S                                *
**********************************